00000000000000000000000000000000000000000000000000000000000000000000000
01111111111111111111111111111111111111111111111111111111111111111111110
01111111111111111111111111111111111111111111111111111111111111111111110
01111111111111111111111111111111111111111111111111111111111111111111110
01111111111111111111111111111111111111111111111111111111111111111111110
01111111101111000001111011111100000111111111111111111111111111111111110
01111111101111011101111011111101111111111111111111111111111111111111110
01111111101111011101111011111100000111111111111111111111111111111111110
01111111101111011101111011111111110111111111111111111111111111111111110
01111111100011000001111000011100000111111111111111111111111111111111110
01111111111111111111111111111111111111111111111111111111111111111111110
01111111111111111111111111111111111111111111111111111111111111111111110
01000111111111111111111111111111111111111111111111111111111111110000110
01110111111111111111111111111111111111111111111111111111111111110111110
01110111111111111111111111111111111111111111111111111111111111110111110
00000000000000000000000000000000000000000000000000000000000000000000000