00000000000000000000000000000000000000000000000000
01111111111111111111111111111111111111111111111110
01011111111111111111111111111111111111111111111110
01111100001111111111111111111111111111111111111110
01111111111111111111111111111111111111000001111110
01111111111111111111111111111111111111111111111110
0111111111111111111111110001111111111111111111111000
0111111111111111111111111111111111111111111111111110
0111111111111111111111111111111111111111111111111110
0111111111111111111111111101111111111111111111111000
01111111111111111111111111111111111111111111111110
01110000000000111111111111111111111111111111111110
01111111111111111111111111111111100000000111111111111111111111111111111111111111111111111111111111000
01111111111111111111111111111111111111111111111111
01111111111111111111111111111111111111111111111110
01111111111111100111111111111111111111111111111110
01111111111111111111111111111111111111111111111110110111101110
01111111111111111111111111111110000000011111111110110111010110
011111111111111111111111111111111111111111111111101100111011100
01111111111111111111111111111111111111111111111110
01111111111111111111100011111111111111111111111110
01111111111111111111111111111111111111111111111110
01111111111111111111111111111111000000011111111110
01111111111111111111111111111111111111111111111110
01111111111111111111111111111111101111111111111110
01111110000000011111111111111111111111111111111110
01111111111111111111111111111111111111111111111110
01111111111111111111111111111111111111111111111110
01111111111111111111111111111111111111111111111110
00000000000000000000000000000000000000000000000000